07 40
########################################
#                                      #
# *****                          ***** #
# *Pg *                          *Br * #
# *****                          ***** #
#                                      #
########################################