07 40
########################################
#                                      #
# ******                        ****** #
# 1Pg05*                        2Nw00* #
# ******                        ****** #
#                                      #
########################################