07 40
########################################
#                                      #
# *****                          ***** #
# 2g05*                          1w00* #
# *****                          ***** #
#                                      #
########################################