07 40
########################################
#                                      #
# ******                        ****** #
# 1Pg10*                        2Nw05* #
# ******                        ****** #
#                                      #
########################################