07 40 00
########################################
# *****                                #
# 1g07*                                #
# *000*                          ***** #
#                                2r05* #
#                                *000* #
########################################