07 40
########################################
# ******                               #
# 1Pg07*                               #
# ******                        ****** #
#                               2Br05* #
#                               ****** #
########################################