07 40
########################################
# *****                                #
# 1g07*                                #
# *****                          ***** #
#                                2r05* #
#                                ***** #
########################################