10 40 00
########################################
#          ***** #                     #
#          1g05* #   *****             #
#          *000* #   4r05*       ***** #
#                #   *000*       2r05* #
#                #               *000* #
# *****                                #
# 3g05*          #                     #
# *000*          #                     #
########################################