10 40
########################################
# ******         #                     #
# 1Pg05*         #   ******            #
# ******         #   4Br05*     ****** #
#                #   ******     2Br05* #
# ******         #              ****** #
# 3Pg05*                               #
# ******         #                     #
#                #                     #
########################################