10 40
########################################
#          ***** #                     #
#          1g05* #   *****             #
#          ***** #   4r05*       ***** #
#                #   *****       2r05* #
#                #               ***** #
# *****                                #
# 3g05*          #                     #
# *****          #                     #
########################################