07 40
########################################
# ******                               #
# 1Pg04*                               #
# ******                        ****** #
#                               2Br09* #
#                               ****** #
########################################