20 50 00
##################################################
#                                                #
#                   *****                        #
#                   4w03*                        #
#                   *000*                        #
#                                                #
# ################################################
#         #                       #              #
# *****   #          *****        #  *****       #
# 1w02*   #          2g03*        #  5w01*       #
# *000*   #          *000*        #  *000*       #
#         #                       #              #
#         #                       ############## #
#         #                                      #
#         #                                      #
#         #         *****                        #
#         #         3w04*                        #
#         #         *000*                        #
#                                                #
##################################################