07 40 00
########################################
#                                      #
# *****                          ***** #
# 2g05*                          1w00* #
# *000*                          *000* #
#                             c        #
########################################