07 40 00
########################################
#                                      #
# *****                          ***** #
# 2g05*                          1w00* #
# *0PROGTREST                    *000* #
#                                      #
########################################
