08 40 00
########################################P
#                                      #R
# *****                          ***** #O
# 2g05*                          1w00* #G
# *000*                          *000* #T
#                                      #E
#                                      #S
########################################T